amuse - bawić
astounding - zdumiewający
bear it - znieść
bobble hat - czapka z pomponem
brass - mosiądz
broom shed - szopa na miotły
cloak - peleryna, płaszcz
clutch - sprzęgło
dare - odważyć się
dull - nudny
flutter - trzepotanie
gibber - bełkot
grin - szeroki uśmiech
hammer - młotek
huddle - nagromadzenie
hum - nucić
knobbly knees - szorstkie kolana
merrily - wesoło
nasty - paskudny
nod glumly - ponuro skinąć głową
oddly - dziwnie
peculiar - osobliwy, szczególny
pinched - ściągnięty, wynędzniały
prodded - popychany
pursed hips - zaciśnięte biodra
quiver - drżeć
reptile house - terrarium
ruffled - potargane
scrammy - bałagan
shudder - dreszcz
slug - ślimak
snigger - chichotać
stern look - surowe spojrzenie
stiffly - twardo
tantrum - furia
tawny - opalony
tin - cyna
tuck - podwinąć
whomping willow - wierzba bijąca
wrestle - zmagać się